18,2,3,2,3,2,3,2,3,2,3,16
18,7,5,4,5,4,5,4,5,4,6,16
18,5,4,5,4,4,4,5,4,6,4,16
18,4,5,4,5,4,5,4,6,4,6,16
18,5,4,5,4,5,4,5,4,6,4,16
18,4,6,4,6,4,6,4,6,4,6,16
18,8,8,8,8,8,8,8,8,8,31,16
20,14,14,14,14,14,14,14,14,14,14,19
